###################
#P                #
#   #             #
#####             #
#      #  #       #
########  #########
#      #  #       #
#                 #
#                 #
#                 #
#        #        #
#                 #
#    #       #    #
#                 #
#      #   #      #
#                 #
###################