#####
#P  #
#   #
##  #
##### 
