####################
#           #      #
# ###       #      #
# # #              #
# ###############  #
#                  #
####################
