####################
#P          #      #
# ###       #      #
# # #              #
# ###############  #
#  #               #
#                  #
####################
